11111111111111111111111
1C0000000CC0000000000C1
10001111110000011111001
1000001001000001CC00001
10100011S10000010000001
101C0001010000011110001
1011111111111111EC10001
1P000000000000000010001
11111111111111111111111