1111111111111
1P000000C0001
1000101111111
10E0100000E01
1111111111111