1111111111111
1P000C0000001
1S00111111001
10E010S000C01
1111111111111