1111111111111
1P000000CS001
1S00101111111
10E0100000C01
1111111111111