1111111111111
1P000000C0001
1S00101111111
1000100000C01
1111111111111