1111CC1111111
1P000000C0001
1S0010111111S
10E0100000C01
1111110011111