111111
1P000000C0001
1S001011111
10E0100000C01
11111111