111111
1P000000C0001
10001011111
10E0100000C01
11111111